0000000000000000
0111111111111110
0111111111111210
0112111133333210
0112111111111210
0112111113333210
0112111111111210
0111111111111110
0000000000000000