0000000000000000
0111111111111110
0112333111333210
0112111111111210
0112333111111210
0112111111111210
0112333111333210
0111111111111110
0000000000000000