0000000000000000
0111111111111110
0111211211331110
0111122111111310
0111122113113110
0111222211111110
0111112111111110
0111111111111110
0000000000000000